NO ./textures/NO
SO ./textures/SO
WE ./textures/EA
EA ./textures/WE

F 220,100,0
C 225,30,0

          111111111111111111111111
1111111111000000110000000000000111
   1111111000001110000000000001
        1001000000000000000000011
111111111011000001110000000000001
100000000011000001110111111111111
11110111111111011100000010001
11110111111111011101010010001
11000000110101011100000010001
11111111111111111111110000011
111111                1000011
11111111111111111111111100001
10000000000000000000000000011
10000000000000000001010010001
11000001110101011111011110N0111
11110111 1110101 101111010001
11111111 1111111 111111111111