NO ./textures/NO
SO ./textures/SO
WE ./textures/EA
EA ./textures/WE

F 220,100,0
C 225,30,0

11111111
10000111
10011111
11111111